111111
110011
101011
101P01
10E011
111111
