111111
11C011
1C1011
101P1
10E011
111111
