111111
11C011
1C1011
111P11
10E011
111111
