111111
11C011
1C1011
100P01
10E111
111111
