11111111111111
1010111CCCCCC1
1100000C000001
100E000P000001
10000111111C01
1000C000001C01
11111111111111
