111111
110011
1C1011
100P01
10E011
111111