111111
11C011
1C1010
101P11
10E011
111111
